 Fields 33
    ID 
    Kv: номер квартала
    Sknr: номер выдела
    Pl: площадь, га
    Vmr: преобладающая порода
    Bon: бонитет
    Mtip: тип леса
    Kmet: год вырубки
    Ku: клюква - урожайность, кг/га
    Kb: клюква - биологический запас, кг
    Ke: клюква - эксплутационный запас, т 
    Bu: брусника - урожайность, кг/га
    Bb: брусника - биологический запас, кг
    Be: брусника - эксплутационный запас, т 
    Hu: черника - урожайность, кг/га
    Hb: черника - биологический запас, кг
    He: черника - эксплутационный запас, т 
    Gu: голубика - урожайность, кг/га
    Gb: голубика - биологический запас, кг
    Ge: голубика - эксплутационный запас, т 
    Mu: морошка - урожайность, кг/га
    Mb: морошка - биологический запас, кг
    Me: морошка - эксплутационный запас, т 
    Su: смородина - урожайность, кг/га
    Sb: смородина - биологический запас, кг
    Se: смородина - эксплутационный запас, т 
    Fu: грибы съедобные - урожайность, кг/га
    Fb: грибы съедобные - биологический запас, кг
    Fe: грибы съедобные - эксплутационный запас, т 
    Cu: орех кедровый - урожайность, кг/га
    Cb: орех кедровый -  биологический запас, кг
    Ce: орех кедровый - эксплутационный запас, т 
    Dost: зона пятикилометровой доступности выдела: 1 - доступный, 2 - недоступный